R 1280 720

NO textures/khafni.xpm

SO textures/hboudhir.xpm

WE textures/aelkhalo.xpm

EA textures/mel-haya.xpm

S textures/sprite_1.xpm

F 184,113,39

C 51,198,227 

11111111111111111111
10000000000000000001
10000000000000000001
10000000000000000001
10000000000000000001
100000000N0000000001
10000000000000000001
10000000000000000001
10000000000000000001
10000000000000000001
11111111111111111111