R 1280 720

NO textures/wall_1.xpm

SO textures/wall_2.xpm

WE textures/wall_3.xpm

EA textures/wall_4.xpm

S textures/sprite_1.xpm

F 100,100,100

C 255,255,255



  111                                                   1111111111111111111111111111111111111111111
  101                                                   10000000000000000000000000000000001000000011
  111                                                   100000000000000000000000000000000000000000011
                                                        1000000000000000000000000000000000000000000011
              1111111  111111111111111111111            10000000000000000000000000000000000000000000011
           1111100001  100011111000000001001            100000000000000000000000000000000000000000000011
        1111100000001  100000011110111111101            1000000000000000000000000000000000000000000000011
  1111111100000000001  10000000000011    11            10000000000000000000000000000000000000000000000011
  1000000000000000001  10000000000111   11111111111     100000100000000000000000000000000000000000000000011
  1100000000000000001  10000000000001   10000000001     1000000100000000000000000000000000000000000000000011
  1111111101111111111  11111110111111   11111111101     10000000000000000000000000000000000000000000000000011
         101                10001               101     100000000000000000000000001000000000000000000000000011
  11111111011111111     111110001111111111111   101111  1000000000000000000000000111000000000000000000000000011
 111000002020000001    1100000000000000000001   100001  10000000000000000000000011 11000000000000000000000000011
  10000000000000001    1000000000000000000001   1100011 1000000000000000000000011   11000000000000000000000000011
  11T00000000000011    1100000000000111110001   1000001 10000000000000000000000011 11000000000000000000000000011
  100000000N000001      1000000000001   10001   1000001 1000000000000000000000000111000000000000000000000000011
  11100000000000011111111000000000001   10001   11000011100000000000000000000000001000000000000000000000000011
   1111000000000000001000000000000001   10001  11100000000000000000000000000000000000000000000000000000000011
   11000000000000000000000000001111111   11111  1000111111000000000000000000000000000000000000000000000000011
   11111000001100000010100000000001            10001    100000000000000000000000000000000000000000000000011
 111000000000000000000000000001111111111111111110001    10000000000000000000000000000000000000000000000011
 111111000000000000000000000000000000000000000000001    1000000000000000000000000000000000000000000000011
     11111100000000000000000011111111111111111000001    100000000000000000000000000000000000000000000011
         1111110000000000111111            111111111    10000000000000000000000000000000000000000000011
             111111111111                               1000000000000000000000000000000000000000000011
                                                        100000000000000000000000000000000000000000011
                                                        10000000000000000000000000000000000000000011
                                                        1111111111111111111111111111111111111111111