R 1920 1080



NO ./path_to_north_texture

SO ./path_to_north_texture

WE ./path_to_north_texture

EA ./path_to_north_texture

S ./path_to_the_sprite_texture

F 220,100,0

C 225,30,0



              1111111111111111111111
              1000000000000000000001
              1000000000000000001111
              1000000000000000001
111111111111111000000011111111001111
10000000000000000000001      1000001111111
111100000000000000000001     100000011111
   100000000000000000001111111000001
111100000000000000000000000000000001
111111111111111111111111111111111111