R 848 480

NO textures/wall_1.xpm

SO textures/wall_2.xpm

WE textures/wall_3.xpm

EA textures/wall_4.xpm

S textures/sprite_1.xpm

F 184,113,39

C 51,198,227

              1111111111111111111111
              1000000000000000000001
          N   1000000000000000001111
              1000000000000000001
111111111111111000000011111111001111
10000000000000000000001      1000001111111
111100000000000000000001     100000011111
   100000000000000000001111111000001
111100000000000000000000000000000001
111111111111111111111111111111111111 